{
  "name": "Framework Laptop 16 RGB Macropad",
  "vendorProductId": 850133011,
  "macros": [
    "{+KC_LGUI}{+KC_LSFT}p{-KC_LGUI}{-KC_LSFT}s",
    "{+KC_LGUI}{+KC_LSFT}p{-KC_LGUI}{-KC_LSFT}b",
    "{+KC_LGUI}{+KC_LSFT}p{-KC_LGUI}{-KC_LSFT}p",
    "{+KC_LGUI}{+KC_LSFT}p{-KC_LGUI}{-KC_LSFT}d",
    "{KC_LGUI,KC_TAB}{200}discord{50}{KC_ENT}",
    "{+KC_LGUI}{+KC_LSFT}a{-KC_LGUI}{-KC_LSFT}f",
    "{+KC_LGUI}{+KC_LSFT}a{-KC_LGUI}{-KC_LSFT}s",
    "{+KC_LGUI}{+KC_LSFT}a{-KC_LGUI}{-KC_LSFT}h",
    "{+KC_LGUI}{+KC_LSFT}a{-KC_LGUI}{-KC_LSFT}j",
    "",
    "",
    "",
    "",
    "",
    "",
    ""
  ],
  "layers": [
    [
      "KC_NLCK",
      "KC_P7",
      "KC_P4",
      "KC_P1",
      "KC_PSLS",
      "KC_P8",
      "KC_P5",
      "KC_P2",
      "KC_P0",
      "KC_PAST",
      "KC_P9",
      "KC_P6",
      "KC_P3",
      "KC_PDOT",
      "KC_PMNS",
      "KC_PPLS",
      "KC_PENT",
      "TO(0)",
      "OSL(2)",
      "KC_NO",
      "OSL(4)",
      "KC_PPLS",
      "KC_PENT",
      "KC_P0",
      "KC_NO",
      "KC_NO",
      "KC_NO",
      "KC_NO",
      "OSL(3)",
      "KC_NO",
      "KC_NO",
      "KC_NO"
    ],
    [
      "KC_TRNS",
      "RGB_SAI",
      "RGB_SAD",
      "RGB_HUI",
      "KC_TRNS",
      "RGB_M_B",
      "RGB_M_SW",
      "RGB_SPI",
      "RGB_HUD",
      "KC_TRNS",
      "RGB_M_R",
      "RGB_M_P",
      "RGB_MOD",
      "RGB_RMOD",
      "RGB_TOG",
      "RGB_VAD",
      "RGB_VAD",
      "KC_TRNS",
      "KC_TRNS",
      "KC_NO",
      "KC_TRNS",
      "RGB_VAI",
      "RGB_VAI",
      "RGB_SPD",
      "KC_NO",
      "KC_NO",
      "KC_NO",
      "KC_NO",
      "KC_TRNS",
      "KC_NO",
      "KC_NO",
      "KC_NO"
    ],
    [
      "MACRO(0)",
      "MACRO(5)",
      "KC_TRNS",
      "KC_TRNS",
      "MACRO(1)",
      "MACRO(6)",
      "KC_TRNS",
      "KC_TRNS",
      "MACRO(4)",
      "MACRO(2)",
      "MACRO(7)",
      "KC_TRNS",
      "KC_TRNS",
      "KC_F14",
      "MACRO(3)",
      "KC_TRNS",
      "KC_F15",
      "KC_TRNS",
      "TO(2)",
      "KC_NO",
      "KC_TRNS",
      "MACRO(8)",
      "KC_TRNS",
      "KC_F13",
      "KC_NO",
      "KC_NO",
      "KC_NO",
      "KC_NO",
      "KC_TRNS",
      "KC_NO",
      "KC_NO",
      "KC_NO"
    ],
    [
      "KC_F13",
      "KC_TRNS",
      "KC_TRNS",
      "KC_TRNS",
      "KC_F14",
      "KC_TRNS",
      "KC_TRNS",
      "KC_TRNS",
      "KC_TRNS",
      "KC_F15",
      "KC_TRNS",
      "KC_TRNS",
      "KC_TRNS",
      "KC_TRNS",
      "KC_TRNS",
      "KC_TRNS",
      "KC_TRNS",
      "KC_TRNS",
      "KC_TRNS",
      "KC_TRNS",
      "KC_TRNS",
      "KC_TRNS",
      "KC_TRNS",
      "KC_TRNS",
      "KC_TRNS",
      "KC_TRNS",
      "KC_TRNS",
      "KC_TRNS",
      "TO(3)",
      "KC_TRNS",
      "KC_TRNS",
      "KC_TRNS"
    ],
    [
      "KC_TRNS",
      "KC_TRNS",
      "KC_TRNS",
      "KC_TRNS",
      "KC_TRNS",
      "KC_TRNS",
      "KC_TRNS",
      "KC_TRNS",
      "KC_TRNS",
      "KC_TRNS",
      "KC_TRNS",
      "KC_TRNS",
      "KC_TRNS",
      "KC_TRNS",
      "KC_TRNS",
      "KC_TRNS",
      "KC_TRNS",
      "KC_TRNS",
      "KC_TRNS",
      "KC_TRNS",
      "TO(4)",
      "KC_TRNS",
      "KC_TRNS",
      "KC_TRNS",
      "KC_TRNS",
      "KC_TRNS",
      "KC_TRNS",
      "KC_TRNS",
      "KC_TRNS",
      "KC_TRNS",
      "KC_TRNS",
      "KC_TRNS"
    ],
    [
      "KC_TRNS",
      "KC_TRNS",
      "KC_TRNS",
      "KC_TRNS",
      "KC_TRNS",
      "KC_TRNS",
      "KC_TRNS",
      "KC_TRNS",
      "KC_TRNS",
      "KC_TRNS",
      "KC_TRNS",
      "KC_TRNS",
      "KC_TRNS",
      "KC_TRNS",
      "KC_TRNS",
      "KC_TRNS",
      "KC_TRNS",
      "KC_TRNS",
      "KC_TRNS",
      "KC_TRNS",
      "KC_TRNS",
      "KC_TRNS",
      "KC_TRNS",
      "KC_TRNS",
      "KC_TRNS",
      "KC_TRNS",
      "KC_TRNS",
      "KC_TRNS",
      "KC_TRNS",
      "KC_TRNS",
      "KC_TRNS",
      "KC_TRNS"
    ],
    [
      "KC_TRNS",
      "KC_TRNS",
      "KC_TRNS",
      "KC_TRNS",
      "KC_TRNS",
      "KC_TRNS",
      "KC_TRNS",
      "KC_TRNS",
      "KC_TRNS",
      "KC_TRNS",
      "KC_TRNS",
      "KC_TRNS",
      "KC_TRNS",
      "KC_TRNS",
      "KC_TRNS",
      "KC_TRNS",
      "KC_TRNS",
      "KC_TRNS",
      "KC_TRNS",
      "KC_TRNS",
      "KC_TRNS",
      "KC_TRNS",
      "KC_TRNS",
      "KC_TRNS",
      "KC_TRNS",
      "KC_TRNS",
      "KC_TRNS",
      "KC_TRNS",
      "KC_TRNS",
      "KC_TRNS",
      "KC_TRNS",
      "KC_TRNS"
    ],
    [
      "KC_TRNS",
      "KC_TRNS",
      "KC_TRNS",
      "KC_TRNS",
      "KC_TRNS",
      "KC_TRNS",
      "KC_TRNS",
      "KC_TRNS",
      "KC_TRNS",
      "KC_TRNS",
      "KC_TRNS",
      "KC_TRNS",
      "KC_TRNS",
      "KC_TRNS",
      "KC_TRNS",
      "KC_TRNS",
      "KC_TRNS",
      "KC_TRNS",
      "KC_TRNS",
      "KC_TRNS",
      "KC_TRNS",
      "KC_TRNS",
      "KC_TRNS",
      "KC_TRNS",
      "KC_TRNS",
      "KC_TRNS",
      "KC_TRNS",
      "KC_TRNS",
      "KC_TRNS",
      "KC_TRNS",
      "KC_TRNS",
      "KC_TRNS"
    ],
    [
      "KC_TRNS",
      "KC_TRNS",
      "KC_TRNS",
      "KC_TRNS",
      "KC_TRNS",
      "KC_TRNS",
      "KC_TRNS",
      "KC_TRNS",
      "KC_TRNS",
      "KC_TRNS",
      "KC_TRNS",
      "KC_TRNS",
      "KC_TRNS",
      "KC_TRNS",
      "KC_TRNS",
      "KC_TRNS",
      "KC_TRNS",
      "KC_TRNS",
      "KC_TRNS",
      "KC_TRNS",
      "KC_TRNS",
      "KC_TRNS",
      "KC_TRNS",
      "KC_TRNS",
      "KC_TRNS",
      "KC_TRNS",
      "KC_TRNS",
      "KC_TRNS",
      "KC_TRNS",
      "KC_TRNS",
      "KC_TRNS",
      "KC_TRNS"
    ],
    [
      "KC_TRNS",
      "KC_TRNS",
      "KC_TRNS",
      "KC_TRNS",
      "KC_TRNS",
      "KC_TRNS",
      "KC_TRNS",
      "KC_TRNS",
      "KC_TRNS",
      "KC_TRNS",
      "KC_TRNS",
      "KC_TRNS",
      "KC_TRNS",
      "KC_TRNS",
      "KC_TRNS",
      "KC_TRNS",
      "KC_TRNS",
      "KC_TRNS",
      "KC_TRNS",
      "KC_TRNS",
      "KC_TRNS",
      "KC_TRNS",
      "KC_TRNS",
      "KC_TRNS",
      "KC_TRNS",
      "KC_TRNS",
      "KC_TRNS",
      "KC_TRNS",
      "KC_TRNS",
      "KC_TRNS",
      "KC_TRNS",
      "KC_TRNS"
    ]
  ],
  "encoders": []
}